continuous_as_the_stars_that_shine	Beauty/Joy
and_twinkle_on_the_milky_way	Beauty/Joy
they_stretched_in_never_ending_line	Beauty/Joy
along_the_margin_of_a_bay	Beauty/Joy
ten_thousand_saw_i_at_a_glance	Beauty/Joy
tossing_their_heads_in_sprightly_dance	Beauty/Joy

success_is_counted_sweetest	Beauty/Joy
by_those_who_ne_er_succeed	Beauty/Joy
to_comprehend_a_nectar	Beauty/Joy
requires_sorest_need	Beauty/Joy

aft_hae_i_rov_d_by_bonie_doon	Beauty/Joy
to_see_the_woodbine_twine	Beauty/Joy
and_ilka_bird_sang_o_’_its_luve	Beauty/Joy
and_sae_did_i_o_’_mine	Beauty/Joy
wi_’_lightsome_heart_i_pu_d_a_rose	Beauty/Joy
upon_its_thorny_tree	Beauty/Joy
but_my_fause_luver_staw_my_rose	Sadness
and_left_the_thorn_wi_’_me	Sadness
wi_’_lightsome_heart_i_pu_d_a_rose	Sadness
upon_a_morn_in_june	Sadness
and_sae_i_flourished_on_the_morn	Sadness
and_sae_was_pu_d_or_noon	Sadness

when_the_stars_threw_down_their_spears	Awe/Sublime
and_watered_heaven_with_their_tears	Awe/Sublime
did_he_smile_his_work_to_see	Awe/Sublime
did_he_who_made_the_lamb_make_thee	Awe/Sublime

my_spirit_is_too_weak—mortality	Sadness
weighs_heavily_on_me_like_unwilling_sleep	Sadness
and_each_imagined_pinnacle_and_steep	Sadness
of_godlike_hardship_tells_me_i_must_die	Sadness
like_a_sick_eagle_looking_at_the_sky	Sadness
yet_‘tis_a_gentle_luxury_to_weep	Sadness
that_i_have_not_the_cloudy_winds_to_keep	Sadness
fresh_for_the_opening_of_the_morning’s_eye	Sadness
such_dim_conceived_glories_of_the_brain	Sadness
bring_round_the_heart_an_indescribable_feud	Sadness
so_do_these_wonders_a_most_dizzy_pain	Sadness
that_mingles_grecian_grandeur_with_the_rude	Sadness
wasting_of_old_time—with_a_billowy_main—	Sadness
a_sun—a_shadow_of_a_magnitude	Sadness

the_sun_is_warm_the_sky_is_clear	Beauty/Joy
the_waves_are_dancing_fast_and_bright	Beauty/Joy
blue_isles_and_snowy_mountains_wear	Beauty/Joy
the_purple_noon_s_transparent_might	Beauty/Joy
the_breath_of_the_moist_earth_is_light	Beauty/Joy
around_its_unexpanded_buds	Beauty/Joy
like_many_a_voice_of_one_delight	Beauty/Joy
the_winds_the_birds_the_ocean_floods	Beauty/Joy
the_city_s_voice_itself_is_soft_like_solitude_s	Beauty/Joy

pain_has_an_element_of_blank	Sadness
it_cannot_recollect	Sadness
when_it_began_or_if_there_were	Sadness
a_day_when_it_was_not	Sadness

tyger_tyger_burning_bright	Beauty/Joy
in_the_forests_of_the_night	Beauty/Joy
what_immortal_hand_or_eye	Beauty/Joy
could_frame_thy_fearful_symmetry	Beauty/Joy

and_what_shoulder_and_what_art	Uneasiness
could_twist_the_sinews_of_thy_heart	Uneasiness
and_when_thy_heart_began_to_beat	Uneasiness
what_dread_hand_and_what_dread_feet	Uneasiness

let_the_world_s_sharpness_like_a_clasping_knife	Beauty/Joy
shut_in_upon_itself_and_do_no_harm	Beauty/Joy
in_this_close_hand_of_love_now_soft_and_warm	Beauty/Joy
and_let_us_hear_no_sound_of_human_strife	Beauty/Joy
after_the_click_of_the_shutting_life_to_life_—	Beauty/Joy
i_lean_upon_thee_dear_without_alarm	Beauty/Joy
and_feel_as_safe_as_guarded_by_a_charm	Beauty/Joy
against_the_stab_of_worldlings_who_if_rife	Beauty/Joy
are_weak_to_injure_very_whitely_still	Beauty/Joy
the_lilies_of_our_lives_may_reassure	Beauty/Joy
their_blossoms_from_their_roots_accessible	Beauty/Joy
alone_to_heavenly_dews_that_drop_not_fewer	Beauty/Joy
growing_straight_out_of_man_s_reach_on_the_hill	Beauty/Joy
god_only_who_made_us_rich_can_make_us_poor	Awe/Sublime

the_flower_that_smiles_to_day	Sadness
to_morrow_dies	Sadness
all_that_we_wish_to_stay	Sadness
tempts_and_then_flies	Sadness
what_is_this_world_s_delight	Sadness
lightning_that_mocks_the_night	Sadness
brief_even_as_bright	Sadness

i_met_a_traveller_from_an_antique_land	Suspense
who_said_two_vast_and_trunkless_legs_of_stone	Suspense
stand_in_the_desert_near_them_on_the_sand	Uneasiness
half_sunk_a_shattered_visage_lies_whose_frown	Uneasiness
and_wrinkled_lip_and_sneer_of_cold_command	Uneasiness
tell_that_its_sculptor_well_those_passions_read	Uneasiness
which_yet_survive_stamped_on_these_lifeless_things	Uneasiness
the_hand_that_mocked_them_and_the_heart_that_fed	Uneasiness
and_on_the_pedestal_these_words_appear	Uneasiness
‘_my_name_is_ozymandias_king_of_kings	Uneasiness
look_on_my_works_ye_mighty_and_despair_’	Uneasiness
nothing_beside_remains_round_the_decay	Sadness
of_that_colossal_wreck_boundless_and_bare	Sadness
the_lone_and_level_sands_stretch_far_away	Sadness

o_captain_my_captain_rise_up_and_hear_the_bells	Vitality
rise_up—for_you_the_flag_is_flung—for_you_the_bugle_trills	Vitality
for_you_bouquets_and_ribbon’d_wreaths—for_you_the_shores_a_crowding	Vitality
for_you_they_call_the_swaying_mass_their_eager_faces_turning	Vitality
here_captain_dear_father	Vitality
this_arm_beneath_your_head	Vitality
it_is_some_dream_that_on_the_deck	Sadness
you’ve_fallen_cold_and_dead	Sadness

now_the_bright_morning_star_day’s_harbinger	Beauty/Joy
comes_dancing_from_the_east_and_leads_with_her	Beauty/Joy
the_flowery_may_who_from_her_green_lap_throws	Beauty/Joy
the_yellow_cowslip_and_the_pale_primrose	Beauty/Joy
hail_bounteous_may_that_dost_inspire	Beauty/Joy
mirth_and_youth_and_warm_desire	Beauty/Joy
woods_and_groves_are_of_thy_dressing	Beauty/Joy
hill_and_dale_doth_boast_thy_blessing	Beauty/Joy
thus_we_salute_thee_with_our_early_song	Beauty/Joy
and_welcome_thee_and_wish_thee_long	Beauty/Joy

whose_herds_with_milk_whose_fields_with_bread	Beauty/Joy
whose_flocks_supply_him_with_attire	Beauty/Joy
whose_trees_in_summer_yield_him_shade	Beauty/Joy
in_winter_fire	Beauty/Joy

a_shudder_in_the_loins_engenders_there	Uneasiness
the_broken_wall_the_burning_roof_and_tower	Uneasiness
and_agamemnon_dead_being_so_caught_up	Uneasiness
so_mastered_by_the_brute_blood_of_the_air	Uneasiness
did_she_put_on_his_knowledge_with_his_power	Uneasiness
before_the_indifferent_beak_could_let_her_drop	Uneasiness

some_might_lament_that_i_were_cold	Sadness
as_i_when_this_sweet_day_is_gone	Sadness
which_my_lost_heart_too_soon_grown_old	Sadness
insults_with_this_untimely_moan	Sadness
they_might_lament_—_for_i_am_one	Sadness
whom_men_love_not_—_and_yet_regret	Sadness
unlike_this_day_which_when_the_sun	Sadness
shall_on_its_stainless_glory_set	Sadness
will_linger_though_enjoyed_like_joy_in_memory_yet	Sadness

my_captain_does_not_answer_his_lips_are_pale_and_still	Sadness
my_father_does_not_feel_my_arm_he_has_no_pulse_nor_will	Sadness
the_ship_is_anchor’d_safe_and_sound_its_voyage_closed_and_done	Vitality
from_fearful_trip_the_victor_ship_comes_in_with_object_won	Vitality
exult_o_shores_and_ring_o_bells	Vitality
but_i_with_mournful_tread	Sadness
walk_the_deck_my_captain_lies	Sadness
fallen_cold_and_dead	Sadness

again_i_see_the_heavenly_fair_despis_d	Annoyance
a_hagg_like_hell_with_gold_more_highly_priz_d	Annoyance
mens_faith_betray_d_their_prince_and_country_sold	Annoyance
their_god_deny_d_all_for_the_idol_gold	Annoyance

music_when_soft_voices_die	Beauty/Joy
vibrates_in_the_memory_—	Beauty/Joy
odours_when_sweet_violets_sicken	Beauty/Joy
live_within_the_sense_they_quicken	Beauty/Joy

when_i_consider_how_my_light_is_spent	Suspense
ere_half_my_days_in_this_dark_world_and_wide	Suspense
and_that_one_talent_which_is_death_to_hide	Sadness
lodged_with_me_useless_though_my_soul_more_bent	Sadness

when_first_alexis_did_in_verse_delight	Beauty/Joy
his_muse_in_low_but_graceful_numbers_walk_t	Beauty/Joy
and_now_and_then_a_little_proudly_stalk_t	Beauty/Joy
but_never_aim_d_at_any_noble_flight	Beauty/Joy
the_herds_the_groves_the_gentle_purling_streams	Beauty/Joy
adorn_d_his_song_and_were_his_highest_theams	Beauty/Joy

the_morning_comes_to_consciousness	Beauty/Joy
of_faint_stale_smells_of_beer	Beauty/Joy
from_the_sawdust_trampled_street	Beauty/Joy
with_all_its_muddy_feet_that_press	Beauty/Joy
to_early_coffee_stands	Beauty/Joy
with_the_other_masquerades	Beauty/Joy
that_time_resumes	Beauty/Joy
one_thinks_of_all_the_hands	Beauty/Joy
that_are_raising_dingy_shades	Beauty/Joy
in_a_thousand_furnished_rooms	Beauty/Joy

death	Humor
is_strictly	Humor
scientific	Humor
amp_artificial_amp	Humor
evil_amp_legal	Humor

of_all_the_poisons_that_the_fruitful_earth	Annoyance
e_er_yet_brought_forth_or_monsters_she_gave_birth	Annoyance
nought_to_mankind_has_e_er_so_fatal_been	Annoyance
as_thou_accursed_gold_their_care_and_sin	Annoyance

but_most_through_midnight_streets_i_hear	Annoyance
how_the_youthful_harlot_s_curse	Annoyance
blasts_the_new_born_infant_s_tear	Annoyance
and_blights_with_plagues_the_marriage_hearse	Annoyance

who_shall_say_i_am_not	Humor
the_happy_genius_of_my_household	Humor

ye_see_yon_birkie_ca_d_a_lord	Humor
wha_struts_an_’_stares_an_’_a_’_that	Humor
tho_’_hundreds_worship_at_his_word	Humor
he_s_but_a_coof_for_a_’_that	Humor
for_a_’_that_an_’_a_’_that	Humor
his_ribband_star_an_’_a_’_that	Humor
the_man_o_’_independent_mind	Humor
he_looks_an_’_laughs_at_a_’_that	Humor

i_carry_your_heart_i_carry_it_in_my_heart	Beauty/Joy

and_the_stately_ships_go_on	Vitality
to_their_haven_under_the_hill	Vitality
but_o_for_the_touch_of_a_vanish_d_hand	Vitality
and_the_sound_of_a_voice_that_is_still	Vitality

how_do_i_love_thee_let_me_count_the_ways	Beauty/Joy
i_love_thee_to_the_depth_and_breadth_and_height	Beauty/Joy
my_soul_can_reach_when_feeling_out_of_sight	Beauty/Joy
for_the_ends_of_being_and_ideal_grace	Beauty/Joy
i_love_thee_to_the_level_of_every_day_s	Beauty/Joy
most_quiet_need_by_sun_and_candle_light	Beauty/Joy
i_love_thee_freely_as_men_strive_for_right	Beauty/Joy
i_love_thee_purely_as_they_turn_from_praise	Beauty/Joy
i_love_thee_with_the_passion_put_to_use	Beauty/Joy
in_my_old_griefs_and_with_my_childhood_s_faith	Beauty/Joy
i_love_thee_with_a_love_i_seemed_to_lose	Beauty/Joy
with_my_lost_saints_i_love_thee_with_the_breath	Beauty/Joy
smiles_tears_of_all_my_life_and_if_god_choose	Beauty/Joy
i_shall_but_love_thee_better_after_death	Beauty/Joy

the_brown_waves_of_fog_toss_up_to_me	Uneasiness
twisted_faces_from_the_bottom_of_the_street	Uneasiness
and_tear_from_a_passer_by_with_muddy_skirts	Uneasiness
an_aimless_smile_that_hovers_in_the_air	Sadness
and_vanishes_along_the_level_of_the_roofs	Sadness

yet_now_despair_itself_is_mild	Sadness
even_as_the_winds_and_waters_are	Sadness
i_could_lie_down_like_a_tired_child	Sadness
and_weep_away_the_life_of_care	Sadness
which_i_have_borne_and_yet_must_bear	Sadness
till_death_like_sleep_might_steal_on_me	Sadness
and_i_might_feel_in_the_warm_air	Sadness
my_cheek_grow_cold_and_hear_the_sea	Sadness
breathe_o_er_my_dying_brain_its_last_monotony	Sadness

sunset_and_evening_star	Beauty/Joy
and_one_clear_call_for_me	Beauty/Joy
and_may_there_be_no_moaning_of_the_bar	Beauty/Joy
when_i_put_out_to_sea	Beauty/Joy

take_up_the_white_man_s_burden	Uneasiness
the_savage_wars_of_peace	Uneasiness
fill_full_the_mouth_of_famine	Uneasiness
and_bid_the_sickness_cease	Uneasiness
and_when_your_goal_is_nearest	Uneasiness
the_end_for_others_sought	Uneasiness
watch_sloth_and_heathen_folly	Uneasiness
bring_all_your_hopes_to_nought	Uneasiness

then_let_us_pray_that_come_it_may	Beauty/Joy
as_come_it_will_for_a_’_that	Beauty/Joy
that_sense_and_worth_o_er_a_’_the_earth	Beauty/Joy
shall_bear_the_gree_an_’_a_’_that	Beauty/Joy
for_a_’_that_an_’_a_’_that	Beauty/Joy
it_s_coming_yet_for_a_’_that	Beauty/Joy
that_man_to_man_the_world_o_er	Beauty/Joy
shall_brothers_be_for_a_’_that	Beauty/Joy

my_blood_approves	Beauty/Joy
and_kisses_are_a_better_fate	Beauty/Joy
than_wisdom	Beauty/Joy
lady_i_swear_by_all_flowers_don_t_cry	Beauty/Joy
—the_best_gesture_of_my_brain_is_less_than	Beauty/Joy
your_eyelids_flutter_which_says	Beauty/Joy

i_hear_america_singing_the_varied_carols_i_hear	Beauty/Joy
those_of_mechanics_each_one_singing_his_as_it_should_be_blithe_and_strong	Beauty/Joy
the_carpenter_singing_his_as_he_measures_his_plank_or_beam	Beauty/Joy
the_mason_singing_his_as_he_makes_ready_for_work_or_leaves_off_work	Beauty/Joy
the_boatman_singing_what_belongs_to_him_in_his_boat_the_deckhand	Beauty/Joy
singing_on_the_steamboat_deck	Beauty/Joy
the_shoemaker_singing_as_he_sits_on_his_bench_the_hatter_singing_as	Beauty/Joy
he_stands	Beauty/Joy
the_wood_cutter_s_song_the_ploughboy_s_on_his_way_in_the_morning	Beauty/Joy
or_at_noon_intermission_or_at_sundown	Beauty/Joy
the_delicious_singing_of_the_mother_or_of_the_young_wife_at_work	Beauty/Joy
or_of_the_girl_sewing_or_washing	Beauty/Joy
each_singing_what_belongs_to_him_or_her_and_to_none_else	Beauty/Joy
the_day_what_belongs_to_the_day_—_at_night_the_party_of_young	Beauty/Joy
fellows_robust_friendly	Beauty/Joy
singing_with_open_mouths_their_strong_melodious_songs	Beauty/Joy

how_dreary_to_be_somebody	Humor
how_public_like_a_frog	Humor
to_tell_your_name_the_livelong_day	Humor
to_an_admiring_bog	Humor

and_then_a_plank_in_reason_broke	Awe/Sublime
and_i_dropped_down_and_down	Awe/Sublime
and_hit_a_world_at_every_plunge	Awe/Sublime
and_finished_knowing_then	Awe/Sublime

death_if_death	Humor
were	Humor
good_for	Humor

tyger_tyger_burning_bright	Beauty/Joy
in_the_forests_of_the_night	Beauty/Joy
what_immortal_hand_or_eye	Beauty/Joy
dare_frame_thy_fearful_symmetry	Beauty/Joy

i_carry_your_heart_with_me_i_carry_it_in	Beauty/Joy
my_heart_i_am_never_without_it_anywhere	Beauty/Joy
i_go_you_go_my_dear_and_whatever_is_done	Beauty/Joy
by_only_me_is_your_doing_my_darling	Beauty/Joy
i_fear	Beauty/Joy

break_break_break	Vitality
at_the_foot_of_thy_crags_o_sea	Vitality
but_the_tender_grace_of_a_day_that_is_dead	Vitality
will_never_come_back_to_me	Vitality

and_then_i_heard_them_lift_a_box	Sadness
and_creak_across_my_soul	Sadness
with_those_same_boots_of_lead_again	Sadness
then_space_began_to_toll	Sadness

if_i_when_my_wife_is_sleeping	Suspense
and_the_baby_and_kathleen	Suspense
are_sleeping	Suspense
and_the_sun_is_a_flame_white_disc	Suspense
in_silken_mists_above_shining_trees_—	Suspense
if_i_in_my_north_room	Suspense
danse_naked_grotesquely	Suspense
before_my_mirror	Suspense
waving_my_shirt_round_my_head	Suspense
and_singing_softly_to_myself	Suspense
“i_am_lonely_lonely	Humor
i_was_born_to_be_lonely	Humor
i_am_best_so_”	Humor
if_i_admire_my_arms_my_face	Humor
my_shoulders_flanks_buttocks	Humor
against_the_yellow_drawn_shades_—	Humor

as_he_defeated_dying	Sadness
on_whose_forbidden_ear	Sadness
the_distant_strains_of_triumph	Sadness
break_agonized_and_clear	Sadness

what_passion_cannot_music_raise_and_quell	Beauty/Joy
when_jubal_struck_the_chorded_shell	Suspense
his_listening_brethren_stood_around	Suspense
and_wondering_on_their_faces_fell	Suspense
to_worship_that_celestial_sound	Suspense
less_than_a_god_they_thought_there_could_not_dwell	Beauty/Joy
within_the_hollow_of_that_shell	Beauty/Joy
that_spoke_so_sweetly_and_so_well	Beauty/Joy
what_passion_cannot_music_raise_and_quell	Beauty/Joy

as_all_the_heavens_were_a_bell	Awe/Sublime
and_being_but_an_ear	Awe/Sublime
and_i_and_silence_some_strange_race	Awe/Sublime
wrecked_solitary_here	Awe/Sublime

a_noiseless_patient_spider	Vitality
i_mark_d_where_on_a_little_promontory_it_stood_isolated	Vitality
mark_d_how_to_explore_the_vacant_vast_surrounding	Vitality
it_launch_d_forth_filament_filament_filament_out_of_itself	Vitality
ever_unreeling_them_ever_tirelessly_speeding_them	Vitality

i_tell_you_hopeless_grief_is_passionless	Sadness
that_only_men_incredulous_of_despair	Sadness
half_taught_in_anguish_through_the_midnight_air	Sadness
beat_upward_to_god’s_throne_in_loud_access	Sadness
of_shrieking_and_reproach_full_desertness	Sadness
in_souls_as_countries_lieth_silent_bare	Sadness
under_the_blanching_vertical_eye_glare	Sadness
of_the_absolute_heavens_deep_hearted_man_express	Sadness
grief_for_thy_dead_in_silence_like_to_death—	Sadness
most_like_a_monumental_statue_set	Sadness
in_everlasting_watch_and_moveless_woe	Sadness
till_itself_crumble_to_the_dust_beneath	Sadness
touch_it_the_marble_eyelids_are_not_wet	Sadness
if_it_could_weep_it_could_arise_and_go	Sadness

sighs_which_are_from_lovers_blown	Beauty/Joy
do_but_gently_heave_the_heart	Beauty/Joy
ev_n_the_tears_they_shed_alone	Beauty/Joy
cure_like_trickling_balm_their_smart	Beauty/Joy
lovers_when_they_lose_their_breath	Beauty/Joy
bleed_away_in_easy_death	Beauty/Joy

how_can_those_terrified_vague_fingers_push	Uneasiness
the_feathered_glory_from_her_loosening_thighs	Uneasiness
and_how_can_body_laid_in_that_white_rush	Uneasiness
but_feel_the_strange_heart_beating_where_it_lies	Uneasiness

i_wandered_lonely_as_a_cloud	Beauty/Joy
that_floats_on_high_over_vales_and_hills	Beauty/Joy
when_all_at_once_i_saw_a_crowd	Beauty/Joy
a_host_of_dancing_daffodills	Beauty/Joy
along_the_lake_beneath_the_trees	Beauty/Joy
ten_thousand_dancing_in_the_breeze	Beauty/Joy

is_there_for_honest_poverty	Sadness
that_hings_his_head_an_’_a_’_that	Sadness
the_coward_slave_—_we_pass_him_by	Sadness
we_dare_be_poor_for_a_’_that	Sadness
for_a_’_that_an_’_a_’_that	Sadness
our_toils_obscure_an_’_a_’_that	Sadness
the_rank_is_but_the_guinea_s_stamp	Sadness
the_man_s_the_gowd_for_a_’_that	Sadness

virtue_how_frail_it_is	Sadness
friendship_how_rare	Sadness
love_how_it_sells_poor_bliss	Sadness
for_proud_despair	Sadness
but_we_though_soon_they_fall	Sadness
survive_their_joy_and_all	Sadness
which_ours_we_call	Sadness

what_the_hammer_what_the_chain	Uneasiness
in_what_furnace_was_thy_brain	Uneasiness
what_the_anvil_what_dread_grasp	Uneasiness
dare_its_deadly_terrors_clasp	Uneasiness

marke_but_this_flea_and_marke_in_this	Humor
how_little_that_which_thou_deny_st_me_is	Humor
it_suck_d_me_first_and_now_sucks_thee	Humor
and_in_this_flea_our_two_bloods_mingled_bee	Humor
thou_know_st_that_this_cannot_be_said	Humor
a_sinne_nor_shame_nor_losse_of_maidenhead	Humor
yet_this_enjoyes_before_it_wooe	Humor
and_pamper_d_swells_with_one_blood_made_of_two	Humor
and_this_alas_is_more_then_wee_would_doe	Humor

my_face_in_thine_eye_thine_in_mine_appears	Beauty/Joy
and_true_plain_hearts_do_in_the_faces_rest	Beauty/Joy
where_can_we_find_two_better_hemispheres	Beauty/Joy
without_sharp_north_without_declining_west	Beauty/Joy
whatever_dies_was_not_mixed_equally	Beauty/Joy
if_our_two_loves_be_one_or_thou_and_i	Beauty/Joy
love_so_alike_that_none_do_slacken_none_can_die	Beauty/Joy

cause_dying_is	Humor

surely_some_revelation_is_at_hand	Suspense
surely_the_second_coming_is_at_hand	Suspense
the_second_coming_hardly_are_those_words_out	Suspense
when_a_vast_image_out_of_spiritus_mundi	Suspense
troubles_my_sight_somewhere_in_sands_of_the_desert	Suspense
a_shape_with_lion_body_and_the_head_of_a_man	Suspense
a_gaze_blank_and_pitiless_as_the_sun	Suspense
is_moving_its_slow_thighs_while_all_about_it	Suspense
reel_shadows_of_the_indignant_desert_birds	Suspense
the_darkness_drops_again_but_now_i_know	Suspense
that_twenty_centuries_of_stony_sleep	Suspense
were_vexed_to_nightmare_by_a_rocking_cradle	Suspense
and_what_rough_beast_its_hour_come_round_at_last	Suspense
slouches_towards_bethlehem_to_be_born	Suspense

it_has_no_future_but_itself	Sadness
its_infinite_realms_contain	Sadness
its_past_enlightened_to_perceive	Sadness
new_periods_of_pain	Sadness

o	Suspense
baby	Suspense
i	Suspense

i_taste_a_liquor_never_brewed	Beauty/Joy
from_tankards_scooped_in_pearl	Beauty/Joy
not_all_the_vats_upon_the_rhine	Beauty/Joy
yield_such_an_alcohol	Beauty/Joy

love_like_spring_tides_full_and_high	Sadness
swells_in_every_youthful_vein	Sadness
but_each_tide_does_less_supply	Sadness
till_they_quite_shrink_in_again	Sadness
if_a_flow_in_age_appear	Sadness

alas_i_have_nor_hope_nor_health	Sadness
nor_peace_within_nor_calm_around	Sadness
nor_that_content_surpassing_wealth	Sadness
the_sage_in_meditation_found	Sadness
and_walked_with_inward_glory_crowned_—	Sadness
nor_fame_nor_power_nor_love_nor_leisure	Sadness
others_i_see_whom_these_surround_—	Sadness
smiling_they_live_and_call_life_pleasure_—	Sadness
to_me_that_cup_has_been_dealt_in_another_measure	Sadness

cannon_to_right_of_them	Uneasiness
cannon_to_left_of_them	Uneasiness
cannon_in_front_of_them	Uneasiness
volley_d_and_thunder_d	Uneasiness
storm_d_at_with_shot_and_shell	Uneasiness
boldly_they_rode_and_well	Uneasiness
into_the_jaws_of_death	Uneasiness
into_the_mouth_of_hell	Uneasiness
rode_the_six_hundred	Uneasiness

bright_star_would_i_were_stedfast_as_thou_art—	Awe/Sublime
not_in_lone_splendour_hung_aloft_the_night	Awe/Sublime
and_watching_with_eternal_lids_apart	Awe/Sublime
like_nature’s_patient_sleepless_eremite	Awe/Sublime
the_moving_waters_at_their_priestlike_task	Beauty/Joy
of_pure_ablution_round_earth’s_human_shores	Beauty/Joy
or_gazing_on_the_new_soft_fallen_mask	Beauty/Joy
of_snow_upon_the_mountains_and_the_moors—	Beauty/Joy
no—yet_still_stedfast_still_unchangeable	Beauty/Joy
pillow’d_upon_my_fair_love’s_ripening_breast	Beauty/Joy
to_feel_for_ever_its_soft_fall_and_swell	Beauty/Joy
awake_for_ever_in_a_sweet_unrest	Beauty/Joy
still_still_to_hear_her_tender_taken_breath	Beauty/Joy
and_so_live_ever—or_else_swoon_to_death	Beauty/Joy

old_age_is	Beauty/Joy
a_flight_of_small	Beauty/Joy
cheeping_birds	Beauty/Joy
skimming	Beauty/Joy
bare_trees_above_a_snow_glaze	Beauty/Joy
gaining_and_failing	Suspense
they_are_buffeted	Suspense
by_a_dark_wind	Suspense
but_what	Suspense
on_harsh_weedstalks	Beauty/Joy
the_flock_has_rested	Beauty/Joy
the_snow	Beauty/Joy
is_covered_with_broken	Beauty/Joy
seedhusks	Beauty/Joy
and_the_wind_tempered	Beauty/Joy
by_a_shrill	Beauty/Joy
piping_of_plenty	Beauty/Joy

